1
1111111111111111
1111111111111111
1111000000000000
1110000000000000
1100000000000000
1000000000000000
1100000000000000
1110000000000000
1111000000000000
1111111111111111
1111111111111111