1
1111111111001111
1111111111001111
0000000000000111
0000000000000011
0000000000000000
0000000000000000
0000000000000000
0000000000000011
0000000000000111
1111111111111111
1111111111111111