1
1111111111111111
1111111111111111
1111111001111111
1111000001111111
1110000001111111
0000000000000000
1110000001111111
1111000001111111
1111111001111111
1111111111111111
1111111111111111