1
1111111111111111
1111111111110011
1111111100000000
1111111000000000
1111110000000000
0000000000000000
1111110022222222
1111111022222222
1111111122222222
1111111122222222
1111111122222222