1
1111111111111111
1111111111111111
0000000000000000
0000000000000000
0000000000000000
0000000000000000
2222222222222222
2222222222222222
2222222222222222
2222222222222222
2222222222222222