1
1111100000111111
1111100000111111
1111100000111111
1111100000111111
0000000000111111
0000000000111111
1111111111111111
1111111111111111
1111111111111111
1111111111111111
1111111111111111