1
1111100000222222
1111100000222222
1111100000222222
1111100000222222
0000000000222222
0000000000222222
2222222222222222
2222222222222222
2222222222222222
2222222222222222
2222222222222222