1
1111100002222222
1111100002222222
1111100002222222
1111100002222222
0000000002222222
0000000002222222
2222222222222222
2222222222222222
2222222222222222
2222222222222222
2222222222222222