1
3333300333333333
3333300333333333
3333300000000000
3333333333333333
0033333333333333
0000003333333333
0000003333333333
3300003333333333
3300000000000000
3333333333333333
3333333333333333