1
1111100111111111
1111100111111111
1111100000000000
1111111111111111
0011111111111111
0000001111111111
0000001111111111
1100001111111111
1100000000000000
1111111111111111
1111111111111111