1
1111111000101011
1111111000101011
0000000000000011
1111111000000001
1111111000000000
1111111000100000
1111111000000000
1111111000000001
0000000000000011
1111111111111111
1111111111111111