1
3333333000303033
3333333000303033
0000000000000033
3333333000000003
3333333000000000
3333333000300000
3333333000000000
3333333000000003
0000000000000033
3333333333333333
3333333333333333