1
1111111111111111
1111111111111111
1100000000000011
1000000000000001
0000010111101001
0000000000000001
0000010100101001
1000000000000001
1100000000000011
1111111111111111
1111111111111111