1
1111022111111111
1111022111111111
1100022000000000
1000022040004000
1000022000400000
1004022040004000
1000022000400000
1000022040004000
1100022000000000
1111122111111111
1111122111111111