1
1111011111111111
1111011111111111
1100011000000000
1000011010001000
1000011000100000
1001011010001000
1000011000100000
1000011010001000
1100011000000000
1111111111111111
1111111111111111