1
1111111111110011
1111111111110011
0000000000000011
0000000010000011
0000000000100001
0010010010000000
0000000000100001
0000000010000011
0000000000000011
1111111111111111
1111111111111111