1
1111111111110011
1111111111110011
0000000000000011
0000000040000011
0000000000400001
0040040040000000
0000000000400001
0000000040000011
0000000000000011
1111111111111111
1111111111111111