1
1130303003030303
1130303003030303
1100000000000000
1100003003030300
1030300000000000
0000003003030300
1030300000000000
1100003003030300
1100000000000000
1133333333333333
1133333333333333