1
1110101001010101
1110101001010101
1100000000000000
1100001001010100
1010100000000000
0000001001010100
1010100000000000
1100001001010100
1100000000000000
1111111111111111
1111111111111111