1
1111111111111111
1111111111111111
0111110000001111
0011110000000111
0001110001000111
0000110010100000
0000000001000111
0000000000000111
0000110000001111
1111111111111111
1111111111111111