1
1111111111111111
1111111111111111
0111110000001111
0011110000000111
0001110004000111
0000110040400000
0000000004000111
0000000000000111
0000110000001111
1111111111111111
1111111111111111