1
3300000000000033
3300000000000033
3300000000000033
3300000000000003
3300000000000000
3300000000000000
3300000000000000
3300000000000003
3300000000000033
3333333333333333
3333333333333333