1
1111111000011101
1111111000011101
1111111000000000
1111111000000000
1111111000001000
0000000000000000
0000000000001000
0000000000000000
0000000000000000
1111111111111111
1111111111111111