1
2222222000033303
2222222000033303
2222222000000000
2222222000000000
2222222000003000
0000000000000000
0000000000003000
0000000000000000
0000000000000000
3333333333333333
3333333333333333