1
1111111100011101
1111111100011101
1111111100000000
1111111100000000
1111111100001000
0000000000000000
0000000000001000
0000000000000000
0000000000000000
1111111111111111
1111111111111111