1
3030003030330333
3030003030330333
0000000000000033
0000000000300003
0030003030000000
0000000000300000
0030003030000000
0000000000300003
0000000000000033
3333333333330033
3333333333333333
