1
1010001010110111
1010001010110111
0000000000000011
0000000000100001
0010001010000000
0000000000100000
0010001010000000
0000000000100001
0000000000000011
1111111111110011
1111111111110011