1
3333033333330333
3333033333330333
3333033000000000
3333030000000333
0000030000000333
0000030000000333
0000030000000333
3333330000000333
3333333000000000
3333333333333333
3333333333333333