1
1111011111110111
1111011111110111
1111011000000000
1111010000000111
0000010000000111
0000010000000111
0000010000000111
1111110000000111
1111111000000000
1111111111111111
1111111111111111