1
1110111111110111
1110111111110111
0000000000100111
1100111111110111
1100111111110000
1100111111110000
1100111111110000
1100111111111111
0000111111111111
1111111111111111
1111111111111111