1
3330333333330333
3330333333330333
0000000000300333
3300333333330333
3300333333330000
3300333333330000
3300333333330000
3300333333333333
0000333333333333
3333333333333333
3333333333333333