1
3333333333333333
3333333333333333
3300000000000000
3003330000000000
0000000000333300
0003330330000000
0000000000333300
3003330000000000
3300000000000000
3333333333333333
3333333333333333