1
1111111111111111
1111111111111111
1100000000000000
1001110000000000
0000000000111100
0001110110000000
0000000000111100
1001110000000000
1100000000000000
1111111111111111
1111111111111111