1
3333300330000033
3333300330000033
3333300030000033
3333300030000033
0000000030000000
0000000030000000
0000000030000000
3333300333333300
3333300333333333
3333300333333333
3333300333333333