1
1111100110000011
1111100110000011
1111100010000011
1111100010000011
0000000010000000
0000000010000000
0000000010000000
1111110011111100
1111110011111111
1111110011111111
1111110011111111