1
1111100110000011
1111100110000011
1111100010000011
1111100010000011
0000000010000000
0000000010000000
0000000010000000
1111100111111100
1111100111111111
1111100111111111
1111100111111111