1
3333003000303033
3333003000303033
3300000000000033
0003000000300003
0000003000000000
0003000000303000
0000003000000000
0003000000300003
3300000000000033
3333333000303033
3333333000303033