1
1111001000101011
1111001000101011
1100000000000011
0001000000100001
0000001000000000
0001000000101000
0000001000000000
0001000000100001
1100000000000011
1111111000101011
1111111000101011