1
1110011110011011
1110011110011011
1110000000000000
1100000000000000
0000003000000000
0000000000000000
0000003000000000
1100000000000000
1110000000000000
1111111111111111
1111111111111111