1
1100022000101011
1100022000101011
0000022000000000
0000022000400000
0000022000004000
0000000000400000
0000022000004000
0000022000400000
0000022000000000
1111022111111111
1111022111111111