1
1100011000101011
1100011000101011
0000011000000000
0000011000100000
0000011000001000
0000000000100000
0000011000001000
0000011000100000
0000011000000000
1111011111111111
1111011111111111