1
1111111111111111
1111111111111111
0000000000000011
0001111000000001
0000000011100000
0001111000000000
0000000011100000
0001111000000001
0000000000000011
1111111111110011
1111111111110011