1
1111111111111111
1111111111111111
0000000000000011
0004444000000001
0000000044400000
0004444000000000
0000000044400000
0004444000000001
0000000000000011
1111111111110011
1111111111110011