1
1111111111111111
1111111111111111
1100000001100011
1001010000001001
0000000000000000
0001010000001000
0000000000000000
1001010000001001
1100000001100011
1111111001111111
1111111001111111