1
1111111111111111
1111111111111111
1100000001100011
1004040000004001
0000000000000000
0004040000004000
0000000000000000
1004040000004001
1100000001100011
1111111001111111
1111111001111111