1
1130303003030303
1130303003030303
1100000000000001
1000300003000301
0030000000000000
0000303003030300
0030000000000000
1000300003000301
1100000000000001
1130303003030303
1130303003030303