1
1110101001010101
1110101001010101
1100000000000001
1000100001000101
0010000000000000
0000101001010100
0010000000000000
1000100001000101
1100000000000001
1110101001010101
1110101001010101