1
1111111001111111
1111111001111111
1100000001111111
1000010001111111
0010000001111111
0000010000000000
0010000000000000
1000010000000000
1100000000000000
1111111111111111
1111111111111111