1
3333333002222222
3333333002222222
3300000002222222
3000030002222222
0030000002222222
0000030000000000
0030000000000000
3000030000000000
3300000000000000
3333333333333333
3333333333333333