1
1111111111111111
1111111111111111
1100000000001111
1000000000001111
1001010101000000
1000000000000000
1001010101000000
1000000000001111
1100000000001111
1111111111001111
1111111111001111