1
3333333333333333
3333333333333333
3300000000003333
3000000000003333
3003030303000000
3000000000000000
3003030303000000
3000000000003333
3300000000003333
3333333333003333
3333333333003333