1
3333333333333333
3333333333333333
3330000000000000
3330000000000000
0000000000000300
0000000000000000
2222222000000300
2222222000000000
2222222000000000
2222222000033303
2222222000033303