1
1111111111111111
1111111111111111
1110000000000000
1110000000000000
0000000000000100
0000000000000000
1111111000000100
1111111000000000
1111111000000000
1111111000011101
1111111000011101