1
3333333333333333
3030003030330033
0000000000000000
0000000000300003
0030003030000003
0000000000300003
0030003030000003
0000000000300003
0000000000000000
3030003030330333
3030003030330333