1
1111111111111111
1010001010110011
0000000000000000
0000000000100001
0010001010000001
0000000000100001
0010001010000001
0000000000100001
0000000000000000
1010001010110111
1010001010110111