1
1111111111111111
1111111111111111
0000000000000111
1111111111110111
1111111111110000
1111111111110000
1111111111110000
1111111111110111
0000011111110111
1111011111110111
1111011111110111