1
3333333333333333
3333333333333333
0000000000000333
3333333333330333
3333333333330000
3333333333330000
3333333333330000
3333333333330333
0000033333330333
3333033333330333
3333033333330333