1
1111111111111111
1110111111110111
1110111111110111
1110111111110111
0000000000000000
0000000000000000
0000000000000000
1110111111110111
1110111111110111
1110111111110111
1110111111110111