1
3333333333333333
3330333333330333
3330333333330333
3330333333330333
0000000000000000
0000000000000000
0000000000000000
3330333333330333
3330333333330333
3330333333330333
3330333333330333