1
1111111111111111
1111111111111111
1100000011110011
1000000001100001
0000030000003001
0000000000000001
0000030000003001
1000000001100001
1100000011110001
1111111111111111
1111111111111111