1
1111111111111111
1111100001111111
1111000001111111
1111000001111111
1100000001111111
1100000001010111
1110000001111111
1111000001111111
1111100001111111
1111100001111111
1111100001111111