1
1111111112222222
1111100002222222
1111000002222222
1111000002222222
1100000002222222
1100000002020222
1110000002222222
1111000002222222
1111100002222222
1111100002222222
1111100002222222