1
1111111111111111
1111111001111111
1100000000000000
1100111111111111
0000111111111111
0000111111111111
0000111111111111
1100111111111111
1100000000000000
1111100110000011
1111100110000011