1
3333333333333333
3333333333333333
3300000000000000
3300333333333333
0000333333333333
0000333333333333
0000333333333333
3300333333333333
3300000000000000
3333300330000033
3333300330000033