1
1111111111111111
1111111001111111
0000000000000011
1100000000000001
1100001000000000
1100000000010000
1100001000000000
1100000000000001
0000000000000011
1111001000101011
1111001000101011