1
3333333333333333
3333333003333333
0000000000000033
3000000000000033
3300003000000000
3300000000030000
3300003000000000
3300000000000003
0000000000000033
3333003000303033
3333003000303033