1
3333333332222222
3333333002222222
3300000002222222
3300030002222222
0000000002222222
0000030000000000
0000000000000033
3300030000000033
3300000000000033
3330033330033033
3330033330033033