1
1111111111111111
1111111001111111
1100000001111111
1100010001111111
0000000001111111
0000010001111111
0000000000000000
1100010000000011
1100000000000011
1110011110011011
1110011110011011