1
1111111111111111
1111111111111111
1111111111111111
1111111111111111
1111111101111111
0000011000000000
1100011000000011
1100011000000011
1100011000000011
1100011000101011
1100011000101011