1
2222222222222222
2222222222222222
2222222222222222
2222222222222222
2222222202222222
0000022000000000
1100022000000011
1100022000000011
1100022000000011
1100022000101011
1100022000101011