1
2222222333333333
2222222003333333
2222222000000000
2222222000000000
2222222000303300
0000000000000000
1110000000303300
1110000000000000
1110000000000000
1113333333333333
1113333333333333