1
1111111111111111
1111111001111111
1111111000000000
1111111000000000
1111111000101100
0000000000000000
1110000000101100
1110000000000000
1110000000000000
1111111111111111
1111111111111111