1
3333333333333333
3333333333333333
0000000000000000
0000000303000303
0000000000000000
0003030303030303
0000000000000000
0000000303000303
0000000000000000
3333333333333333
3333333333333333