1
3333333333333333
3333333003333333
0000000000000003
3030003003030003
0000000000000000
3030303003030300
0000000000000000
3030003003030003
0000000000000003
3330303003030303
3330303003030303