1
1111111111111111
1111111001111111
1111111001111111
1111111001111111
0000000000000000
0000000000000000
0000000001111111
1111111001111111
1111111001111111
1111111001111111
1111111001111111