1
3333333333333333
3333333300333333
3333333300333333
3333333300333333
0000000000000000
0000000000000000
0000000002222222
3333333002222222
3333333002222222
3333333002222222
3333333002222222